0,0,2,0,0,0,2,0,0
4,1,5,6,0,6,5,1,4
4,1,1,5,3,5,1,1,4
4,1,5,6,0,6,5,1,4
0,0,2,0,0,0,2,0,0
