0,0,0,0,0,0,0,0,0
0,0,2,1,5,1,1,5,0
3,5,1,1,1,1,1,5,4
0,5,1,1,5,1,2,0,0
0,0,0,0,0,0,0,0,0
