0,0,0,0,3,0,0,0,0
0,1,1,1,1,6,1,1,0
4,5,0,0,0,0,0,5,4
0,1,1,6,1,1,1,1,0
0,0,0,0,3,0,0,0,0
