0,0,0,0,0,0,0,0,0
0,0,0,6,1,5,5,1,0
4,1,6,6,1,5,5,1,3
4,1,6,6,1,5,0,0,0
0,0,0,0,0,0,0,0,0
