0,0,0,0,4,0,0,0,0
0,1,1,1,6,0,6,1,0
4,1,1,6,5,6,1,1,3
0,1,1,1,6,0,6,1,0
0,0,0,0,4,0,0,0,0
