0,0,1,1,1,0,0
0,1,1,6,1,1,0
4,1,6,0,6,1,3
0,1,1,6,1,1,0
0,0,1,1,1,0,0
