0,0,4,0,4,0,0,4,0
0,2,5,1,6,1,6,1,0
4,5,1,6,5,6,1,1,3
0,2,5,1,6,1,6,1,0
0,0,4,0,4,0,0,4,0
