0,0,0,0,0,0,0,0,0
4,5,1,0,1,6,1,1,0
4,5,1,5,6,4,6,1,3
4,5,1,0,1,6,1,1,0
0,0,0,0,0,0,0,0,0
